111111111111111111111111111111111111111
1000P0C00C000000E0000000000000000000001
100000000000001110000000000100011110001
1000000O0000000000000000001100000C10001
1000C0000011110000000000010100011110001
10000001111000C00000000011111001C000001
100000000000000000000000000100011110001
100000000000000000C00000000000000000001
10000000000000000000000001100000000C001
10000C000000000000000111111110000000001
100000000000000011111100011111110000001
100000001111111110000000011000000000001
100000000001100000C0000000111100000C001
100000011111111100000000011111110000001
100000000000000111111011110000000000001
1000000C0000000000001010000000000000001
10000000000000000111101110000000C000001
1000C0000111111111000C00111110000000001
100000000001111111111000000000011110001
1000000C0000000000111111111111111111111
111111111111111111111111111111111111111
