111111111111111111111
1000P0C00C000000E0001
100000000000001110001
1000000O0000000000001
1000C0000011110000001
10000001111000C000001
100000000000000000001
100000000000000000C01
100000000000000000001
111111111111111111111
