111111111111111
1P0000000C00001
100000000000001
100C00000000001
10000000C000001
111111111111111
